4 4 4 4 4 4 4 4 4 4 4 4 4 4 4 4 4 4 4 4 4 4 4 4 4 4 4 4 4 4 4 4 4 4 4 4 4 4 4 4 4 4 4 4 4 4 4 4 4 4 4 4 4 4 4 4 4 4 4 4 4 4 4 4 4 4 4 4 4 4 4 4 4 4 4 4 4 4 4 4 4 4 4 4 4 4 4 4 4 4 4 4 4 4 4 4 4 4 4 4 
4 4 4 4 4 4 4 4 4 4 4 4 4 4 4 4 4 4 4 4 4 4 4 4 4 4 4 4 4 4 4 4 4 4 4 4 4 4 4 4 4 4 4 4 4 4 4 4 4 4 4 4 4 4 4 4 4 4 4 4 4 4 4 4 4 4 4 4 4 4 4 4 4 4 4 4 4 4 4 4 4 4 4 4 4 4 4 4 4 4 4 4 4 4 4 4 4 4 4 4 
4 4 4 4 4 4 4 4 4 4 4 4 4 4 4 4 4 4 4 4 4 4 4 4 4 4 4 4 4 4 4 4 4 4 4 4 4 4 4 4 4 4 4 4 4 4 4 4 4 4 4 4 4 4 4 4 4 4 4 4 4 4 4 4 4 4 4 4 4 4 4 4 4 4 4 4 4 4 4 4 4 4 4 4 4 4 4 4 4 4 4 4 4 4 4 4 4 4 4 4 
4 4 4 4 4 4 4 4 4 4 4 4 4 4 4 4 4 4 4 4 4 4 4 4 4 4 4 4 4 4 4 4 4 4 4 4 4 4 4 4 4 4 4 4 4 4 4 4 4 4 4 4 4 4 4 4 4 4 4 4 4 4 4 4 4 4 4 4 4 4 4 4 4 4 4 4 4 4 4 4 4 4 4 4 4 4 4 4 4 4 4 4 4 4 4 4 4 4 4 4 
4 4 4 4 4 4 4 4 4 4 4 4 4 4 4 4 4 4 4 4 4 4 4 4 4 4 4 4 4 4 4 4 4 4 4 4 4 4 4 4 4 4 4 4 4 4 1 1 1 4 4 4 4 4 4 4 4 4 4 4 4 4 4 4 4 4 4 4 4 4 4 4 4 4 4 4 4 4 4 4 4 4 4 4 4 4 4 4 4 4 4 4 4 4 4 4 4 4 4 4 
4 4 4 4 4 4 4 4 4 4 4 4 4 4 4 4 4 4 4 4 4 4 4 4 4 4 4 4 4 4 12 12 4 4 17 17 1 17 7 7 7 7 1 1 1 1 1 1 1 1 1 1 4 4 4 4 4 4 4 4 4 4 4 4 4 4 4 4 4 4 4 4 4 4 4 4 4 4 4 4 4 4 4 4 4 4 4 4 4 4 4 4 4 4 4 4 4 4 4 4 
4 4 4 4 4 4 4 4 4 4 4 4 4 4 4 4 4 4 4 4 4 4 4 4 4 4 4 4 4 12 1 1 1 17 17 17 17 17 8 8 8 8 1 1 1 1 1 1 1 1 1 1 4 4 4 4 4 4 4 4 4 4 4 4 4 4 4 4 4 4 4 4 4 4 4 4 4 4 4 4 4 4 4 4 4 4 4 4 4 4 4 4 4 4 4 4 4 4 4 4 
4 4 4 4 4 4 4 4 4 4 4 4 4 4 4 4 4 4 4 4 4 4 4 4 4 4 12 20 21 22 23 24 25 26 17 17 17 7 8 9 9 8 7 17 17 17 1 1 1 1 1 1 1 1 1 1 17 17 4 4 4 4 4 4 4 4 4 4 4 4 4 4 4 4 4 4 4 4 4 4 4 4 4 4 4 4 4 4 4 4 4 4 4 4 4 4 4 4 4 4 
4 4 4 4 4 4 4 4 4 4 4 4 4 4 4 4 4 4 4 4 4 4 4 4 4 12 17 27 28 29 30 31 32 33 17 17 17 8 8 0 0 8 8 17 17 17 1 1 1 1 1 1 1 1 1 17 17 17 17 1 4 4 4 4 4 4 4 4 4 4 4 4 4 4 4 4 4 4 4 4 4 4 4 4 4 4 4 4 4 4 4 4 4 4 4 4 4 4 4 4 
4 4 4 4 4 4 4 4 4 4 4 4 4 4 4 4 4 4 4 4 4 4 4 4 12 17 17 34 35 36 37 38 39 40 17 17 17 8 9 56 57 9 8 17 17 17 17 17 17 1 1 1 1 1 17 17 17 17 17 17 17 1 1 4 4 4 4 4 4 4 4 4 4 4 4 4 4 4 4 4 4 4 4 4 4 4 4 4 4 4 4 4 4 4 4 4 4 4 4 4 
4 4 4 4 4 4 4 4 4 4 4 4 4 4 4 4 4 4 4 4 4 4 12 12 17 17 17 41 42 43 44 45 46 47 17 17 17 8 59 60 61 62 8 17 17 17 17 17 17 17 1 1 1 17 17 17 17 17 17 17 17 1 1 1 1 1 4 4 4 4 4 4 4 4 4 4 4 4 4 4 4 4 4 4 4 4 4 4 4 4 4 4 4 4 4 4 4 4 4 4 
4 4 4 4 4 4 4 4 4 4 4 4 4 4 4 4 4 4 4 4 12 12 12 17 17 17 1 48 49 50 51 52 53 54 17 17 17 8 63 64 65 66 8 17 17 17 17 17 17 17 17 17 17 17 17 17 17 17 17 17 17 17 1 1 1 1 0 0 1 0 1 1 12 12 12 4 4 4 4 4 4 4 4 4 4 4 4 4 4 4 4 4 4 4 4 4 4 4 4 4 
4 4 4 4 4 4 4 4 4 4 4 4 4 4 4 4 4 4 4 17 17 17 56 57 17 17 0 17 19 19 19 15 1 17 17 17 17 9 67 68 69 70 9 17 17 17 17 17 17 17 17 17 17 17 17 17 17 17 17 17 17 17 1 1 1 0 0 0 0 0 1 1 1 12 12 17 17 17 17 17 1 12 12 12 12 12 1 4 4 4 4 4 4 4 4 4 4 4 4 4 
4 4 4 4 4 4 4 4 4 4 4 4 4 4 4 4 4 1 17 17 17 59 60 61 62 17 17 17 19 19 19 0 0 0 1 17 15 19 19 19 19 19 17 17 17 17 17 17 17 17 17 17 17 17 17 17 17 17 17 17 17 17 17 17 0 0 0 0 1 0 0 1 1 1 12 1 1 17 17 17 17 17 12 12 12 12 12 12 12 1 1 4 4 4 4 4 4 4 4 4 
4 4 4 4 4 4 4 4 4 4 4 4 4 4 4 4 4 1 1 17 17 63 64 65 66 17 2 0 0 19 19 19 19 0 0 1 19 19 19 19 19 19 17 17 17 17 17 17 17 17 17 17 17 17 17 17 1 17 17 17 17 17 17 1 1 1 0 0 0 0 0 0 0 1 1 1 1 1 17 17 17 17 17 17 17 12 12 12 12 12 12 1 1 1 4 4 4 4 4 4 
4 4 4 4 4 4 4 4 4 4 4 4 4 4 4 4 1 1 1 17 17 67 68 69 70 17 15 2 19 19 19 19 19 19 0 19 19 0 1 17 17 17 17 17 17 17 17 17 17 17 17 2 2 2 0 0 1 17 17 17 17 17 17 1 1 1 1 0 0 0 0 0 0 0 0 1 1 1 1 1 1 1 17 17 17 17 17 17 17 12 12 12 12 1 4 4 4 4 4 4 
4 4 4 4 4 4 4 4 4 4 4 4 4 4 4 1 1 1 17 17 17 19 19 19 19 19 19 19 19 19 19 19 19 19 19 19 19 0 1 1 17 17 17 17 17 17 17 17 17 0 2 2 2 2 0 0 0 1 1 17 17 17 17 17 17 0 0 0 0 0 0 0 0 1 0 0 0 1 1 1 1 1 1 1 17 17 17 1 17 17 17 12 12 12 1 17 4 4 4 4 
4 4 4 4 4 4 4 4 4 4 4 4 4 4 1 1 1 17 17 17 17 19 19 19 19 19 19 19 19 19 19 19 19 19 19 19 19 1 1 1 1 1 1 1 17 17 17 17 0 0 2 2 2 2 0 0 0 1 1 17 17 17 17 17 1 0 0 0 0 0 0 0 0 3 3 1 0 2 1 1 1 1 0 1 1 1 1 1 2 2 2 17 17 17 12 1 1 4 4 4 
4 4 4 4 4 4 4 4 4 4 4 4 1 1 1 17 17 17 17 17 17 17 17 17 17 17 17 17 17 0 19 19 19 19 19 19 0 1 1 1 6 6 6 1 17 17 17 0 0 0 3 3 3 3 3 0 0 0 1 17 17 17 17 1 1 1 1 1 0 0 0 1 3 3 3 3 1 3 2 2 2 2 0 0 1 1 2 2 2 2 2 2 2 1 1 1 1 4 4 4 
4 4 4 4 4 4 4 4 4 4 4 4 1 1 17 17 20 21 22 23 24 25 26 17 17 17 17 17 17 17 17 17 19 19 19 19 19 19 1 1 6 6 6 6 1 1 17 3 3 3 3 3 3 3 3 3 3 3 1 17 17 17 1 1 1 1 1 6 0 0 1 3 3 3 3 3 3 3 1 2 2 2 2 0 0 1 2 2 2 2 2 2 2 1 1 1 6 4 4 4 
4 4 4 4 4 4 4 4 4 4 4 4 1 1 17 17 27 28 29 30 31 32 33 1 1 1 1 17 17 17 17 19 19 19 19 19 19 19 1 1 1 6 6 6 6 1 3 3 3 3 3 3 3 3 3 3 3 0 1 17 17 17 1 1 1 1 1 1 0 0 3 3 3 3 3 3 3 3 3 3 0 1 2 2 0 1 2 2 2 2 2 2 2 1 1 1 1 4 4 4 
4 4 4 4 4 4 4 4 4 4 4 1 1 17 17 17 34 35 36 37 38 39 40 17 17 19 19 19 19 19 19 19 19 19 19 19 19 19 19 1 1 1 6 6 6 1 3 3 3 3 3 3 3 3 3 3 1 1 1 17 17 17 1 1 1 1 1 1 0 3 3 3 3 3 3 3 3 3 3 3 3 1 1 1 1 1 0 0 0 0 7 7 7 7 1 1 1 4 4 4 
4 4 4 4 4 4 4 4 4 4 4 0 0 17 17 17 41 42 43 44 45 46 47 19 19 19 19 19 19 19 19 19 0 0 19 19 19 19 19 19 1 1 1 6 6 1 1 3 3 3 3 3 3 3 3 3 1 1 1 17 17 1 1 1 1 1 1 1 3 3 3 3 3 3 3 3 3 3 3 3 3 3 0 0 0 0 0 7 7 7 8 8 8 8 7 17 4 4 4 4 
4 4 4 4 4 4 4 4 4 4 4 0 0 17 17 17 48 49 50 51 52 53 54 19 19 19 19 19 19 19 19 0 0 0 19 19 1 19 19 19 19 1 1 1 1 1 1 1 3 3 3 3 3 3 1 1 1 1 17 17 17 1 1 1 1 1 1 1 0 0 3 3 3 3 3 3 3 3 3 3 3 0 0 7 0 0 7 8 8 8 8 8 8 8 8 17 4 4 4 4 
4 4 4 4 4 4 4 4 4 4 0 0 0 17 17 0 19 19 19 19 19 19 19 19 19 19 19 0 0 0 0 0 0 6 19 19 1 1 19 19 19 19 19 1 1 1 1 1 1 3 3 3 3 1 1 1 1 1 17 17 1 1 0 1 1 1 1 1 0 0 0 3 3 3 3 3 3 3 3 3 3 0 7 8 7 7 8 8 8 8 8 9 9 8 8 4 4 4 4 4 
4 4 4 4 4 4 4 4 4 4 0 0 0 0 17 0 19 19 19 19 19 19 19 19 19 19 0 0 0 0 0 0 0 1 19 19 1 1 19 19 19 19 19 19 1 1 1 1 1 1 1 1 1 1 1 1 1 1 17 1 1 1 1 1 1 1 1 1 1 0 0 0 1 3 3 3 3 3 3 3 0 7 8 8 8 8 8 8 8 8 9 0 0 9 9 4 4 4 4 4 
4 4 4 4 4 4 4 4 4 0 0 0 0 0 17 17 17 17 17 17 17 17 17 2 0 0 0 0 0 0 1 0 1 1 19 19 1 1 19 1 1 1 19 19 19 1 1 1 1 1 1 1 1 1 1 1 1 1 1 1 1 1 1 1 17 17 1 1 1 1 0 0 0 0 1 3 3 3 7 7 7 8 8 8 8 8 9 9 9 9 0 0 0 0 4 4 4 4 4 4 
4 4 4 4 4 4 4 4 4 0 0 0 0 0 0 17 17 17 17 17 17 17 2 2 2 0 0 2 0 0 0 1 1 1 19 19 1 1 19 1 1 1 1 19 19 19 19 1 1 1 1 1 1 1 1 1 1 1 1 1 1 1 1 1 17 17 17 17 17 17 17 1 0 0 0 1 0 0 8 8 8 8 8 8 9 9 3 0 0 3 3 3 0 4 4 4 4 4 4 4 
4 4 4 4 4 4 4 4 4 4 0 0 0 0 0 0 0 0 0 0 0 2 2 2 2 2 2 2 0 1 1 1 1 1 19 19 1 1 19 1 1 1 1 1 19 19 1 19 19 1 19 1 1 1 1 1 1 1 1 1 1 1 1 1 17 17 17 17 17 17 17 17 17 17 1 17 0 7 8 8 8 8 9 9 1 1 3 3 3 3 0 3 0 0 4 4 4 4 4 4 
4 4 4 4 4 4 4 4 4 4 0 0 0 0 0 0 0 0 0 0 0 2 2 2 2 2 2 2 2 2 1 1 1 19 19 1 1 1 19 1 1 17 1 1 15 19 1 1 1 1 1 1 19 19 19 19 19 19 19 19 1 17 17 17 17 17 17 17 17 17 17 17 17 17 17 17 17 9 8 3 3 1 1 3 3 3 3 3 3 3 3 3 0 0 4 4 4 4 4 4 
4 4 4 4 4 4 4 4 4 4 0 0 0 0 0 0 0 0 0 0 0 1 2 2 2 2 2 2 2 1 1 1 19 19 1 1 1 1 19 1 1 17 17 1 1 19 1 0 1 1 2 1 1 2 1 1 1 1 2 1 1 17 17 17 17 17 17 17 17 17 17 17 17 17 17 17 17 17 9 3 3 3 3 3 1 3 1 3 3 3 0 3 3 4 4 4 4 4 4 4 
4 4 4 4 4 4 4 4 4 4 4 1 1 1 1 1 1 1 1 1 1 1 2 2 2 2 2 2 2 1 19 19 19 1 1 17 17 1 19 1 1 17 17 17 1 58 19 1 1 1 1 1 1 1 0 1 1 1 1 1 1 1 17 17 17 17 17 17 17 17 17 17 17 17 17 17 17 17 17 3 3 3 1 1 1 1 10 10 1 1 1 1 3 4 4 4 4 4 4 4 
4 4 4 4 4 4 4 4 4 4 1 1 1 20 21 22 23 24 25 26 1 1 1 2 2 2 2 2 19 19 19 19 1 1 17 17 17 1 19 1 1 17 17 17 1 1 19 1 2 1 1 1 0 3 3 3 1 1 1 1 1 15 1 17 17 17 17 17 17 17 17 17 17 17 17 17 17 17 17 1 1 3 3 1 1 10 10 1 1 4 1 1 1 4 4 4 4 4 4 4 
4 4 4 4 4 4 4 4 4 4 1 1 1 27 28 29 30 31 32 33 1 1 1 1 1 1 19 19 19 19 19 1 17 17 17 17 17 1 19 1 1 17 17 17 1 1 58 19 1 0 2 1 1 1 1 3 3 3 1 1 1 1 1 1 17 17 17 17 17 17 17 17 17 17 17 17 17 17 17 1 1 1 3 1 10 10 1 1 1 4 4 1 1 4 4 4 4 4 4 4 
4 4 4 4 4 4 4 4 4 4 1 1 1 34 35 36 37 38 39 40 1 1 1 1 1 19 19 19 19 1 1 1 17 17 17 17 17 1 19 1 1 17 17 17 1 1 1 19 1 1 2 1 1 1 1 3 3 3 3 1 1 1 1 1 17 17 17 17 17 17 17 17 17 17 17 17 17 17 17 17 1 1 1 16 10 1 1 1 4 4 4 4 4 4 4 4 4 4 4 4 
4 4 4 4 4 4 4 4 4 4 1 1 1 41 42 43 44 45 46 47 1 1 1 19 19 19 19 19 1 1 1 17 17 17 17 17 17 1 19 1 1 17 17 17 17 1 1 19 19 1 1 1 3 3 3 3 3 1 3 3 3 3 3 1 1 17 17 17 17 17 17 17 17 17 17 17 17 17 17 17 17 1 1 10 1 1 1 1 4 4 4 4 4 4 4 4 4 4 4 4 
4 4 4 4 4 4 4 4 4 4 1 1 1 48 49 50 51 52 53 54 19 19 19 19 19 19 19 1 1 1 17 17 17 17 17 17 17 1 19 1 1 17 17 17 17 1 1 1 19 1 2 0 3 3 0 0 1 3 3 3 3 3 3 1 1 1 17 17 17 17 17 17 17 17 17 17 17 17 17 17 17 1 1 10 1 1 1 4 4 4 4 4 4 4 4 4 4 4 4 4 
4 4 4 4 4 4 4 4 4 4 1 1 1 1 1 1 1 1 1 19 19 19 19 19 19 19 1 1 1 17 17 17 17 17 17 17 17 1 19 1 1 17 17 17 17 17 1 1 58 19 1 1 1 1 1 0 0 3 3 3 3 3 3 1 1 1 1 1 17 17 17 17 17 17 17 17 17 17 17 17 17 1 1 10 1 1 1 4 4 4 4 4 4 4 4 4 4 4 4 4 
4 4 4 4 4 4 4 4 4 4 4 1 1 1 1 1 1 1 1 1 1 1 1 1 1 1 1 1 17 17 17 17 17 17 17 17 17 1 19 1 1 17 17 17 17 17 1 1 1 19 2 1 1 1 1 1 1 1 1 1 1 3 3 3 1 1 1 1 17 17 17 17 17 17 17 17 17 17 17 17 17 1 1 10 1 1 1 4 4 4 4 4 4 4 4 4 4 4 4 4 
4 4 4 4 4 4 4 4 4 4 4 1 1 1 1 3 3 3 3 3 1 1 3 3 1 1 1 17 17 17 17 17 17 17 17 17 17 1 19 1 1 17 17 17 17 17 17 1 1 19 1 1 1 1 58 56 57 1 1 1 1 1 1 1 1 1 1 17 17 17 17 17 17 17 17 17 17 17 17 17 1 1 1 10 1 1 1 4 4 4 4 4 4 4 4 4 4 4 4 4 
4 4 4 4 4 4 4 4 4 4 4 1 1 3 3 3 3 3 3 3 3 3 3 3 1 1 17 17 17 17 17 17 17 17 17 17 17 1 19 1 1 17 17 17 17 17 17 17 1 19 1 1 1 1 59 60 61 62 1 1 1 0 0 0 1 1 1 17 17 17 17 17 17 17 17 17 17 17 17 17 1 1 1 10 1 1 1 4 4 4 4 4 4 4 4 4 4 4 4 4 
4 4 4 4 4 4 4 4 4 4 4 4 1 1 3 3 3 3 3 3 3 3 1 1 0 17 17 17 17 17 17 17 17 17 17 17 17 1 19 1 1 17 17 17 17 17 17 17 1 19 19 1 1 1 63 64 65 66 1 1 1 0 0 1 1 17 17 17 17 17 17 17 17 17 17 17 17 17 17 1 1 1 1 10 1 3 1 4 4 4 4 4 4 4 4 4 4 4 4 4 
4 4 4 4 4 4 4 4 4 4 4 4 1 1 3 3 1 1 1 1 0 1 1 1 17 17 17 17 17 17 17 17 17 17 17 17 1 1 19 1 1 17 17 17 17 17 17 17 1 1 2 19 1 1 67 68 69 70 1 1 1 1 0 0 17 17 17 17 17 17 17 17 17 17 17 17 17 17 17 1 1 1 10 1 1 1 1 4 4 4 4 4 4 4 4 4 4 4 4 4 
4 4 4 4 4 4 4 4 4 4 4 4 1 1 1 1 1 1 1 1 1 17 17 17 17 17 17 17 17 17 17 17 17 17 17 17 1 19 1 1 1 17 17 17 17 17 17 17 17 1 1 19 19 1 1 1 1 1 1 1 1 17 17 17 17 17 17 17 17 17 17 17 17 17 17 17 17 1 1 1 1 1 10 1 1 3 1 4 4 4 4 4 4 4 4 4 4 4 4 4 
4 4 4 4 4 4 4 4 4 4 4 4 1 1 1 1 1 1 17 17 17 17 17 17 17 17 17 17 17 17 17 17 17 17 17 1 1 19 1 1 1 17 17 17 17 17 17 17 17 1 1 1 19 1 1 1 1 1 1 1 17 17 17 17 17 17 17 17 17 17 17 17 17 17 17 17 17 1 1 1 3 1 1 10 1 3 1 4 4 4 4 4 4 4 4 4 4 4 4 4 
4 4 4 4 4 4 4 4 4 4 4 4 4 1 1 1 17 17 17 17 17 17 17 17 17 17 17 17 17 17 17 1 1 1 1 1 19 1 1 1 1 17 17 17 17 17 17 17 17 1 1 2 1 19 1 2 1 1 17 17 17 17 17 17 17 17 17 17 1 1 1 17 17 17 17 17 1 1 3 3 3 1 1 10 1 3 1 4 4 4 4 4 4 4 4 4 4 4 4 4 
4 4 4 4 4 4 4 4 4 4 4 4 4 4 1 1 17 17 17 17 17 17 17 17 17 17 17 17 17 1 58 56 57 1 1 1 19 1 1 1 1 17 17 17 17 17 17 17 17 17 1 1 1 1 19 1 1 1 1 17 17 17 17 17 17 0 0 0 0 0 1 1 1 1 17 1 1 3 3 3 3 1 10 1 1 3 1 4 4 4 4 4 4 4 4 4 4 4 4 4 
4 4 4 4 4 4 4 4 4 4 4 4 4 4 1 1 17 17 17 17 17 17 17 17 17 17 17 17 1 1 59 60 61 62 1 1 19 1 1 1 17 17 17 17 17 17 17 17 17 17 17 1 1 1 1 19 1 1 1 1 1 17 17 17 0 1 0 0 0 0 0 1 1 1 17 1 1 3 3 3 1 1 10 1 1 1 4 4 4 4 4 4 4 4 4 4 4 4 4 4 
4 4 4 4 4 4 4 4 4 4 4 4 4 4 4 1 17 17 17 17 17 17 17 17 17 17 1 55 55 55 63 64 65 66 1 1 19 1 1 1 17 17 17 17 17 17 17 17 17 17 17 17 1 1 1 1 19 19 19 1 1 0 1 1 1 1 1 3 3 3 3 3 3 1 1 1 1 3 1 1 1 1 10 1 1 1 4 4 4 4 4 4 4 4 4 4 4 4 4 4 
4 4 4 4 4 4 4 4 4 4 4 4 4 4 4 1 17 17 17 17 17 17 17 17 1 1 1 1 1 1 67 68 69 70 1 19 1 1 1 55 17 17 17 17 17 17 17 17 17 17 17 17 17 1 3 1 1 2 1 19 1 1 2 1 1 3 3 3 3 3 3 3 1 1 1 1 1 1 1 10 10 10 1 1 3 3 1 4 4 4 4 4 4 4 4 4 4 4 4 4 
4 4 4 4 4 4 4 4 4 4 4 4 4 4 4 1 17 17 17 17 17 17 17 0 1 1 1 3 3 1 1 1 1 1 1 19 1 1 1 55 17 17 17 17 17 17 17 17 17 17 17 17 17 55 55 1 1 1 1 19 1 1 1 1 1 3 1 1 1 0 0 0 0 0 0 10 10 10 10 1 1 1 1 1 3 3 1 4 4 4 4 4 4 4 4 4 4 4 4 4 
4 4 4 4 4 4 4 4 4 4 4 4 4 4 4 1 1 17 17 17 17 0 1 0 0 3 3 3 3 3 1 1 1 1 19 1 1 1 1 17 17 17 17 17 17 17 17 17 17 17 17 55 55 55 3 1 3 1 1 1 19 19 1 1 1 1 1 1 10 10 10 10 10 10 10 1 1 1 1 1 0 1 3 3 3 3 1 4 4 4 4 4 4 4 4 4 4 4 4 4 
4 4 4 4 4 4 4 4 4 4 4 4 4 4 4 1 1 1 1 1 1 0 3 3 3 3 3 3 3 3 1 1 1 19 1 1 1 1 58 17 17 17 17 17 17 17 17 17 17 55 55 55 3 3 3 3 3 3 1 1 1 2 19 1 1 2 10 10 1 1 0 1 1 0 1 1 1 0 1 1 1 1 1 3 3 1 1 4 4 4 4 4 4 4 4 4 4 4 4 4 
4 4 4 4 4 4 4 4 4 4 4 4 4 4 4 4 1 1 1 1 3 3 3 3 3 3 3 3 3 1 1 19 19 1 1 58 58 58 58 58 3 58 58 17 3 17 55 55 55 55 55 3 3 3 3 3 3 3 3 1 1 1 58 19 1 10 1 1 1 3 3 3 1 1 1 1 1 0 1 1 17 17 1 1 3 1 1 4 4 4 4 4 4 4 4 4 4 4 4 4 
4 4 4 4 4 4 4 4 4 4 4 4 4 4 4 4 1 3 3 3 3 3 3 3 3 3 3 0 3 1 58 19 1 1 1 58 58 58 3 3 3 3 58 3 3 3 55 3 3 3 3 3 3 3 3 3 3 3 3 55 1 1 1 19 19 2 1 1 3 3 1 1 1 1 17 17 17 17 17 17 17 17 17 1 1 1 1 4 4 4 4 4 4 4 4 4 4 4 4 4 
4 4 4 4 4 4 4 4 4 4 4 4 4 4 4 4 1 3 3 1 3 1 3 3 3 3 0 0 0 58 19 0 0 1 58 58 58 58 3 3 3 3 3 3 3 3 3 3 3 3 55 55 55 55 55 55 55 55 55 55 55 1 2 1 19 1 1 1 1 3 1 17 17 17 17 17 17 17 17 17 17 17 17 1 1 1 1 1 4 4 4 4 4 4 4 4 4 4 4 4 
4 4 4 4 4 4 4 4 4 4 4 4 4 4 4 4 1 1 3 3 3 3 3 3 3 1 1 1 58 19 1 0 0 0 58 3 3 3 3 3 3 3 3 3 3 3 3 3 3 55 55 55 55 55 55 55 17 17 17 17 55 55 1 1 58 19 1 1 1 3 3 1 1 17 17 17 17 17 17 17 17 17 17 17 1 1 1 1 4 4 4 4 4 4 4 4 4 4 4 4 
4 4 4 4 4 4 4 4 4 4 4 4 4 4 4 4 1 1 1 3 3 3 3 0 1 1 1 19 58 1 58 58 58 1 3 3 3 3 3 3 3 3 3 55 55 55 3 55 55 55 55 17 17 17 17 17 17 17 17 17 55 55 1 1 1 19 19 1 2 1 1 1 1 1 17 17 17 17 17 17 17 17 17 17 17 1 1 1 4 4 4 4 4 4 4 4 4 4 4 4 
4 4 4 4 4 4 4 4 4 4 4 4 4 4 4 4 4 1 1 1 3 3 3 1 0 19 19 58 58 58 58 58 58 3 3 3 3 3 58 58 55 55 55 55 55 55 55 55 55 17 17 17 17 17 17 17 17 17 17 17 17 55 1 1 1 1 19 1 1 1 1 2 1 1 1 17 17 17 17 17 17 17 17 17 17 17 1 1 1 4 4 4 4 4 4 4 4 4 4 4 
4 4 4 4 4 4 4 4 4 4 4 4 4 4 4 4 4 1 1 1 1 3 1 1 1 1 58 58 58 58 58 58 58 0 55 55 55 55 55 55 55 55 55 17 17 17 17 17 17 17 17 17 17 17 17 17 17 17 1 1 3 3 1 1 1 1 1 19 1 1 1 1 1 1 1 1 17 17 17 17 17 17 17 17 17 17 17 1 1 1 4 4 4 4 4 4 4 4 4 4 
4 4 4 4 4 4 4 4 4 4 4 4 4 4 4 4 4 4 1 1 1 1 1 1 19 1 1 1 58 58 58 58 55 55 55 55 55 55 17 17 17 17 17 17 17 17 17 17 17 17 17 17 17 17 17 17 17 1 55 3 3 3 3 3 1 1 2 1 19 19 1 1 1 2 1 1 1 17 17 17 17 17 17 17 17 17 17 1 1 1 4 4 4 4 4 4 4 4 4 4 
4 4 4 4 4 4 4 4 4 4 4 4 4 4 4 4 4 4 4 1 1 1 1 19 1 1 1 0 58 58 0 1 1 17 17 17 17 17 17 17 17 17 17 17 17 17 17 17 17 17 17 17 17 17 17 17 17 1 2 1 55 3 3 3 3 1 1 1 1 58 19 1 1 1 1 1 1 17 17 17 17 17 17 17 17 17 17 17 1 1 4 4 4 4 4 4 4 4 4 4 
4 4 4 4 4 4 4 4 4 4 4 4 4 4 4 4 4 4 4 1 1 1 19 1 1 1 1 1 58 1 0 0 17 17 17 17 17 17 17 17 17 17 17 17 17 17 17 17 17 17 17 17 17 17 17 17 1 1 5 1 55 55 55 3 3 3 3 1 1 1 1 19 1 1 1 2 1 1 17 17 17 17 17 17 17 17 17 17 1 1 1 1 4 4 4 4 4 4 4 4 
4 4 4 4 4 4 4 4 4 4 4 4 4 4 4 4 4 4 4 1 1 1 1 1 1 1 1 1 1 1 1 1 17 17 17 17 17 17 17 17 17 17 17 17 17 17 17 17 17 17 17 17 17 17 17 17 1 5 5 5 1 55 55 55 1 3 3 3 3 1 1 1 19 1 1 1 1 1 17 17 17 17 17 17 17 17 17 17 17 1 1 1 4 4 4 4 4 4 4 4 
4 4 4 4 4 4 4 4 4 4 4 4 4 4 4 4 4 4 4 1 1 1 1 1 1 1 1 1 17 1 1 1 17 17 17 17 17 17 17 17 17 17 17 17 17 17 17 17 17 17 17 17 17 17 17 1 1 5 5 5 5 5 2 1 1 3 3 3 3 3 1 1 19 1 1 1 1 2 1 17 17 17 17 17 17 17 17 17 17 1 1 4 4 4 4 4 4 4 4 4 
4 4 4 4 4 4 4 4 4 4 4 4 4 4 4 4 4 4 4 1 1 1 1 1 1 1 1 1 1 17 17 17 17 17 17 17 17 17 17 17 17 17 17 17 17 17 17 17 17 17 17 17 17 17 17 17 1 5 5 5 5 5 5 1 1 1 2 1 1 3 1 1 1 19 1 1 1 1 1 1 17 17 17 17 17 17 17 17 17 1 1 1 1 4 4 4 4 4 4 4 
4 4 4 4 4 4 4 4 4 4 4 4 4 4 4 4 4 4 4 1 1 1 1 1 1 1 1 1 1 17 17 17 17 17 17 17 17 17 17 17 17 17 17 17 17 17 17 17 17 17 17 17 17 17 17 1 2 5 5 5 5 5 5 1 2 55 55 1 1 1 1 1 1 1 19 19 1 1 3 1 1 17 17 17 17 17 17 17 17 17 1 1 1 4 4 4 4 4 4 4 
4 4 4 4 4 4 4 4 4 4 4 4 4 4 4 4 4 4 4 1 1 1 1 1 1 1 1 1 1 1 17 17 17 17 17 17 17 17 17 17 17 17 17 17 17 17 17 17 17 17 17 17 17 17 17 17 1 5 5 5 5 5 5 5 5 1 55 1 1 3 1 1 1 1 1 19 19 2 1 3 3 1 1 1 1 1 1 17 17 17 17 1 1 1 4 4 4 4 4 4 
4 4 4 4 4 4 4 4 4 4 4 4 4 4 4 4 4 4 4 1 1 1 1 1 1 1 1 1 17 17 17 17 17 17 17 17 17 17 17 17 17 17 17 17 17 17 17 17 17 17 17 17 17 17 17 1 1 1 5 5 5 5 5 5 5 2 1 1 3 3 3 3 1 1 1 1 58 19 1 3 1 1 1 1 56 57 1 1 1 17 17 17 1 1 4 4 4 4 4 4 
4 4 4 4 4 4 4 4 4 4 4 4 4 4 4 4 4 4 4 4 4 1 1 1 1 1 1 1 17 17 17 17 17 17 17 17 17 17 17 17 17 17 17 17 17 17 17 17 17 17 17 17 17 17 17 1 1 1 2 5 5 5 5 5 5 1 1 3 3 3 3 3 1 1 1 1 1 19 19 1 1 2 1 59 60 61 62 1 1 1 17 17 17 1 1 1 4 4 4 4 
4 4 4 4 4 4 4 4 4 4 4 4 4 4 4 4 4 4 4 4 4 4 4 4 1 1 1 1 1 17 17 17 17 17 17 17 17 17 17 17 17 17 17 17 17 17 17 17 17 17 17 17 17 17 17 17 17 1 1 5 5 5 5 5 5 5 1 1 1 3 3 3 3 1 1 1 1 1 19 1 1 1 1 63 64 65 66 1 1 1 17 17 17 1 1 1 4 4 4 4 
4 4 4 4 4 4 4 4 4 4 4 4 4 4 4 4 4 4 4 4 4 4 4 4 4 4 1 1 2 1 1 17 17 17 1 17 17 17 17 17 17 17 17 17 17 17 17 17 17 17 17 17 17 17 17 17 17 1 1 2 1 1 5 5 5 5 1 1 3 3 3 2 1 17 17 17 1 58 58 19 1 1 1 67 68 69 70 1 1 1 1 1 1 1 1 1 4 4 4 4 
4 4 4 4 4 4 4 4 4 4 4 4 4 4 4 4 4 4 4 4 4 4 4 4 4 4 4 4 1 1 1 1 1 1 1 1 17 1 1 17 17 17 17 17 17 17 17 17 17 17 17 17 17 17 17 17 17 17 55 1 1 1 1 1 1 55 1 1 3 3 3 3 1 17 17 17 17 1 1 19 19 19 19 19 19 19 1 1 1 1 1 1 1 1 1 1 1 4 4 4 
4 4 4 4 4 4 4 4 4 4 4 4 4 4 4 4 4 4 4 4 4 4 4 4 4 4 4 4 1 1 1 1 1 1 1 2 1 1 1 1 1 1 17 17 17 17 17 17 17 17 17 17 17 17 17 17 17 17 17 17 55 1 3 3 1 1 1 2 3 3 3 1 1 17 17 17 17 1 1 1 1 58 1 1 1 1 3 1 3 1 3 3 3 1 1 1 1 4 4 4 
4 4 4 4 4 4 4 4 4 4 4 4 4 4 4 4 4 4 4 4 4 4 4 4 4 4 4 4 4 4 4 4 4 1 1 1 1 1 1 1 1 1 17 17 17 17 17 17 17 17 17 17 17 17 17 17 17 17 17 17 1 1 2 1 3 3 1 3 3 3 3 1 1 17 17 17 17 17 1 1 1 58 58 1 3 3 3 3 3 3 3 3 3 1 3 1 1 4 4 4 
4 4 4 4 4 4 4 4 4 4 4 4 4 4 4 4 4 4 4 4 4 4 4 4 4 4 4 4 4 4 4 4 4 4 4 4 1 4 1 2 1 1 1 1 1 1 1 17 17 17 17 17 17 17 17 17 17 17 17 1 1 1 1 3 3 3 3 3 3 3 3 1 1 17 17 17 17 17 17 17 17 1 58 1 1 1 1 3 3 3 3 1 3 3 3 1 1 4 4 4 
4 4 4 4 4 4 4 4 4 4 4 4 4 4 4 4 4 4 4 4 4 4 4 4 4 4 4 4 4 4 4 4 4 4 4 4 4 4 4 1 1 1 2 1 1 1 1 17 17 1 17 17 17 17 17 17 17 17 17 17 17 1 1 1 1 3 3 3 3 3 3 1 1 17 17 17 17 17 17 17 17 17 17 17 1 1 1 1 3 1 3 3 3 3 1 1 4 4 4 4 
4 4 4 4 4 4 4 4 4 4 4 4 4 4 4 4 4 4 4 4 4 4 4 4 4 4 4 4 4 4 4 4 4 4 4 4 4 4 4 4 4 1 1 2 2 2 2 2 1 1 1 17 17 1 17 17 17 17 17 17 17 1 1 3 3 3 3 3 3 3 3 1 17 17 17 17 17 17 17 17 17 17 17 17 17 17 1 1 1 3 3 3 1 1 1 1 4 4 4 4 
4 4 4 4 4 4 4 4 4 4 4 4 4 4 4 4 4 4 4 4 4 4 4 4 4 4 4 4 4 4 4 4 4 4 4 4 4 4 4 4 4 4 1 4 1 1 1 2 2 2 2 2 2 1 1 1 1 1 1 1 1 1 3 3 3 1 3 3 3 3 1 1 17 17 17 17 17 17 17 17 17 17 17 17 17 17 1 1 1 1 1 1 1 1 1 4 4 4 4 4 
4 4 4 4 4 4 4 4 4 4 4 4 4 4 4 4 4 4 4 4 4 4 4 4 4 4 4 4 4 4 4 4 4 4 4 4 4 4 4 4 4 4 4 4 1 1 1 4 1 1 1 1 2 2 2 1 1 1 1 3 3 3 3 1 3 3 3 3 3 1 1 17 17 17 17 17 17 17 17 17 17 17 17 17 17 17 17 17 1 1 1 1 1 1 1 4 4 4 4 4 
4 4 4 4 4 4 4 4 4 4 4 4 4 4 4 4 4 4 4 4 4 4 4 4 4 4 4 4 4 4 4 4 4 4 4 4 4 4 4 4 4 4 4 4 4 4 1 4 4 4 1 1 1 1 1 1 3 3 3 3 3 3 3 3 3 3 3 3 3 1 17 17 17 17 17 17 17 17 17 17 17 17 17 17 17 17 17 17 17 1 1 1 1 4 4 4 4 4 4 4 
4 4 4 4 4 4 4 4 4 4 4 4 4 4 4 4 4 4 4 4 4 4 4 4 4 4 4 4 4 4 4 4 4 4 4 4 4 4 4 4 4 4 4 4 4 4 4 4 4 4 4 4 4 1 1 1 3 3 3 3 3 3 3 3 3 3 1 1 1 1 17 17 17 17 17 17 17 17 17 17 17 17 17 17 17 17 17 17 17 1 1 1 4 4 4 4 4 4 4 4 
4 4 4 4 4 4 4 4 4 4 4 4 4 4 4 4 4 4 4 4 4 4 4 4 4 4 4 4 4 4 4 4 4 4 4 4 4 4 4 4 4 4 4 4 4 4 4 4 4 4 4 4 4 1 1 1 1 3 3 3 3 3 3 3 3 3 1 1 1 17 17 17 17 17 17 17 17 17 17 17 17 17 17 17 17 17 17 1 1 1 1 1 4 4 4 4 4 4 4 4 
4 4 4 4 4 4 4 4 4 4 4 4 4 4 4 4 4 4 4 4 4 4 4 4 4 4 4 4 4 4 4 4 4 4 4 4 4 4 4 4 4 4 4 4 4 4 4 4 4 4 4 4 4 4 1 1 1 1 3 3 3 3 3 1 3 1 1 17 17 17 17 17 17 17 17 17 17 17 17 17 17 17 17 17 17 1 1 1 1 4 4 4 4 4 4 4 4 4 4 4 
4 4 4 4 4 4 4 4 4 4 4 4 4 4 4 4 4 4 4 4 4 4 4 4 4 4 4 4 4 4 4 4 4 4 4 4 4 4 4 4 4 4 4 4 4 4 4 4 4 4 4 4 4 4 4 4 1 3 3 3 3 1 1 1 17 17 17 17 17 17 17 17 17 17 17 17 17 17 17 17 17 17 17 1 1 1 1 1 4 4 4 4 4 4 4 4 4 4 4 4 
4 4 4 4 4 4 4 4 4 4 4 4 4 4 4 4 4 4 4 4 4 4 4 4 4 4 4 4 4 4 4 4 4 4 4 4 4 4 4 4 4 4 4 4 4 4 4 4 4 4 4 4 4 4 4 4 1 3 3 3 3 1 1 17 17 17 17 17 17 17 17 17 17 17 17 17 17 17 17 17 17 1 1 1 1 1 1 4 4 4 4 4 4 4 4 4 4 4 4 4 
4 4 4 4 4 4 4 4 4 4 4 4 4 4 4 4 4 4 4 4 4 4 4 4 4 4 4 4 4 4 4 4 4 4 4 4 4 4 4 4 4 4 4 4 4 4 4 4 4 4 4 4 4 4 4 4 1 3 1 1 1 1 17 17 17 17 17 17 17 17 17 17 17 17 17 17 17 17 17 17 17 1 1 1 1 1 1 4 4 4 4 4 4 4 4 4 4 4 4 4 
4 4 4 4 4 4 4 4 4 4 4 4 4 4 4 4 4 4 4 4 4 4 4 4 4 4 4 4 4 4 4 4 4 4 4 4 4 4 4 4 4 4 4 4 4 4 4 4 4 4 4 4 4 4 4 4 4 1 1 1 1 1 17 17 17 17 17 17 17 17 17 17 17 17 17 17 17 17 17 17 1 1 1 4 1 4 4 4 4 4 4 4 4 4 4 4 4 4 4 4 
4 4 4 4 4 4 4 4 4 4 4 4 4 4 4 4 4 4 4 4 4 4 4 4 4 4 4 4 4 4 4 4 4 4 4 4 4 4 4 4 4 4 4 4 4 4 4 4 4 4 4 4 4 4 4 4 4 4 1 1 1 1 1 1 1 1 1 1 1 1 17 17 1 17 17 17 17 17 17 1 1 1 1 4 4 4 4 4 4 4 4 4 4 4 4 4 4 4 4 4 
4 4 4 4 4 4 4 4 4 4 4 4 4 4 4 4 4 4 4 4 4 4 4 4 4 4 4 4 4 4 4 4 4 4 4 4 4 4 4 4 4 4 4 4 4 4 4 4 4 4 4 4 4 4 4 4 4 1 1 1 1 1 1 1 1 1 1 1 1 1 1 1 1 1 1 1 1 1 1 4 4 4 4 4 4 4 4 4 4 4 4 4 4 4 4 4 4 4 4 4 
4 4 4 4 4 4 4 4 4 4 4 4 4 4 4 4 4 4 4 4 4 4 4 4 4 4 4 4 4 4 4 4 4 4 4 4 4 4 4 4 4 4 4 4 4 4 4 4 4 4 4 4 4 4 4 4 4 4 4 4 1 1 1 1 1 1 1 1 1 1 1 1 1 1 1 1 1 4 4 4 4 4 4 4 4 4 4 4 4 4 4 4 4 4 4 4 4 4 4 4 
4 4 4 4 4 4 4 4 4 4 4 4 4 4 4 4 4 4 4 4 4 4 4 4 4 4 4 4 4 4 4 4 4 4 4 4 4 4 4 4 4 4 4 4 4 4 4 4 4 4 4 4 4 4 4 4 4 4 4 4 4 4 4 4 4 4 4 1 4 4 4 4 4 4 1 1 4 4 4 4 4 4 4 4 4 4 4 4 4 4 4 4 4 4 4 4 4 4 4 4 
4 4 4 4 4 4 4 4 4 4 4 4 4 4 4 4 4 4 4 4 4 4 4 4 4 4 4 4 4 4 4 4 4 4 4 4 4 4 4 4 4 4 4 4 4 4 4 4 4 4 4 4 4 4 4 4 4 4 4 4 4 4 4 4 4 4 4 4 4 4 4 4 4 4 4 4 4 4 4 4 4 4 4 4 4 4 4 4 4 4 4 4 4 4 4 4 4 4 4 4 
4 4 4 4 4 4 4 4 4 4 4 4 4 4 4 4 4 4 4 4 4 4 4 4 4 4 4 4 4 4 4 4 4 4 4 4 4 4 4 4 4 4 4 4 4 4 4 4 4 4 4 4 4 4 4 4 4 4 4 4 4 4 4 4 4 4 4 4 4 4 4 4 4 4 4 4 4 4 4 4 4 4 4 4 4 4 4 4 4 4 4 4 4 4 4 4 4 4 4 4 
4 4 4 4 4 4 4 4 4 4 4 4 4 4 4 4 4 4 4 4 4 4 4 4 4 4 4 4 4 4 4 4 4 4 4 4 4 4 4 4 4 4 4 4 4 4 4 4 4 4 4 4 4 4 4 4 4 4 4 4 4 4 4 4 4 4 4 4 4 4 4 4 4 4 4 4 4 4 4 4 4 4 4 4 4 4 4 4 4 4 4 4 4 4 4 4 4 4 4 4 
4 4 4 4 4 4 4 4 4 4 4 4 4 4 4 4 4 4 4 4 4 4 4 4 4 4 4 4 4 4 4 4 4 4 4 4 4 4 4 4 4 4 4 4 4 4 4 4 4 4 4 4 4 4 4 4 4 4 4 4 4 4 4 4 4 4 4 4 4 4 4 4 4 4 4 4 4 4 4 4 4 4 4 4 4 4 4 4 4 4 4 4 4 4 4 4 4 4 4 4 
4 4 4 4 4 4 4 4 4 4 4 4 4 4 4 4 4 4 4 4 4 4 4 4 4 4 4 4 4 4 4 4 4 4 4 4 4 4 4 4 4 4 4 4 4 4 4 4 4 4 4 4 4 4 4 4 4 4 4 4 4 4 4 4 4 4 4 4 4 4 4 4 4 4 4 4 4 4 4 4 4 4 4 4 4 4 4 4 4 4 4 4 4 4 4 4 4 4 4 4 
4 4 4 4 4 4 4 4 4 4 4 4 4 4 4 4 4 4 4 4 4 4 4 4 4 4 4 4 4 4 4 4 4 4 4 4 4 4 4 4 4 4 4 4 4 4 4 4 4 4 4 4 4 4 4 4 4 4 4 4 4 4 4 4 4 4 4 4 4 4 4 4 4 4 4 4 4 4 4 4 4 4 4 4 4 4 4 4 4 4 4 4 4 4 4 4 4 4 4 4 
4 4 4 4 4 4 4 4 4 4 4 4 4 4 4 4 4 4 4 4 4 4 4 4 4 4 4 4 4 4 4 4 4 4 4 4 4 4 4 4 4 4 4 4 4 4 4 4 4 4 4 4 4 4 4 4 4 4 4 4 4 4 4 4 4 4 4 4 4 4 4 4 4 4 4 4 4 4 4 4 4 4 4 4 4 4 4 4 4 4 4 4 4 4 4 4 4 4 4 4 
4 4 4 4 4 4 4 4 4 4 4 4 4 4 4 4 4 4 4 4 4 4 4 4 4 4 4 4 4 4 4 4 4 4 4 4 4 4 4 4 4 4 4 4 4 4 4 4 4 4 4 4 4 4 4 4 4 4 4 4 4 4 4 4 4 4 4 4 4 4 4 4 4 4 4 4 4 4 4 4 4 4 4 4 4 4 4 4 4 4 4 4 4 4 4 4 4 4 4 4 
