041 041 041 041 041 041 041 041 041 041 041 041 041 041 041 041 041 041 041 041 041 041 041 041 041 041 041 041 041 041 041 041 041 041 041 041 041 041 041 041 041 041 041 041 041 041 041 041 041 041
041 032 040 040 040 040 040 040 040 040 040 040 040 040 040 040 040 040 040 040 040 040 040 040 040 040 040 040 040 040 040 040 044 041 041 041 041 041 041 041 041 041 041 041 041 041 041 041 041 041
041 033 038 038 038 038 038 038 038 038 038 038 038 038 038 038 038 038 038 038 038 038 038 038 038 038 038 038 038 038 038 038 046 041 041 041 041 041 041 041 041 041 041 041 041 041 041 041 041 041
041 033 038 038 038 038 038 038 038 038 038 038 038 038 038 038 038 038 038 038 038 038 038 038 038 038 038 038 038 038 038 038 046 041 041 041 041 041 041 041 041 041 041 041 041 041 041 041 041 041
041 033 038 038 038 038 038 038 038 038 038 038 038 038 038 038 038 038 038 038 038 038 038 038 038 038 038 038 038 038 038 038 046 041 041 041 041 041 041 041 041 041 041 041 041 041 041 041 041 041
041 033 038 038 038 038 038 038 038 038 038 038 038 038 038 038 038 038 038 038 038 038 038 038 038 038 038 038 038 038 038 038 046 041 041 041 041 041 041 041 041 041 041 041 041 041 041 041 041 041 
041 033 038 038 038 038 038 038 038 038 038 038 038 038 038 038 038 038 038 038 038 038 038 038 038 038 038 038 038 038 038 038 046 041 041 041 041 041 041 041 041 041 041 041 041 041 041 041 041 041 
041 033 038 038 038 038 038 038 038 038 038 038 038 038 038 038 038 038 038 038 038 038 038 038 038 038 038 038 038 038 038 038 046 041 041 041 041 041 041 041 041 041 041 041 041 041 041 041 041 041 
041 033 038 038 038 038 038 038 038 038 038 038 038 038 038 038 038 038 038 038 038 038 038 038 038 038 038 038 038 038 038 038 046 041 041 041 041 041 041 041 041 041 041 041 041 041 041 041 041 041
041 033 038 038 038 038 038 038 038 038 038 038 038 038 038 038 038 038 038 038 038 038 038 038 038 038 038 038 038 038 038 038 046 041 041 041 041 041 041 041 041 041 041 041 041 041 041 041 041 041 
041 033 038 038 038 038 038 038 038 038 038 038 038 038 038 038 038 038 038 038 038 038 038 038 038 038 038 038 038 038 038 038 046 041 041 041 041 041 041 041 041 041 041 041 041 041 041 041 041 041
041 033 038 038 038 038 038 038 038 038 038 038 038 038 038 038 038 038 038 038 038 038 038 038 038 038 038 038 038 038 038 038 046 041 041 041 041 041 041 041 041 041 041 041 041 041 041 041 041 041 
041 033 038 038 038 038 038 038 038 038 038 038 038 038 038 038 038 038 038 038 038 038 038 038 038 038 038 038 038 038 038 038 046 041 041 041 041 041 041 041 041 041 041 041 041 041 041 041 041 041 
041 035 039 039 039 039 039 039 039 039 039 039 039 039 039 039 039 039 039 039 039 039 039 039 039 039 039 039 039 039 039 039 047 041 041 041 041 041 041 041 041 041 041 041 041 041 041 041 041 041
041 041 041 041 041 041 041 041 041 041 041 041 041 041 041 041 041 041 041 041 041 041 041 041 041 041 041 041 041 041 041 041 041 041 041 041 041 041 041 041 041 041 041 041 041 041 041 041 041 041
041 041 041 041 041 041 041 041 041 041 041 041 041 041 041 041 041 041 041 041 041 041 041 041 041 041 041 041 041 041 041 041 041 041 041 041 041 041 041 041 041 041 041 041 041 041 041 041 041 041
041 041 041 041 041 041 041 041 041 041 041 041 041 041 041 041 041 041 041 041 041 041 041 041 041 041 041 041 041 041 041 041 041 041 041 041 041 041 041 041 041 041 041 041 041 041 041 041 041 041
041 041 041 041 041 041 041 041 041 041 041 041 041 041 041 041 041 041 041 041 041 041 041 041 041 041 041 041 041 041 041 041 041 041 041 041 041 041 041 041 041 041 041 041 041 041 041 041 041 041
041 041 041 041 041 041 041 041 041 041 041 041 041 041 041 041 041 041 041 041 041 041 041 041 041 041 041 041 041 041 041 041 041 041 041 041 041 041 041 041 041 041 041 041 041 041 041 041 041 041
041 041 041 041 041 041 041 041 041 041 041 041 041 041 041 041 041 041 041 041 041 041 041 041 041 041 041 041 041 041 041 041 041 041 041 041 041 041 041 041 041 041 041 041 041 041 041 041 041 041
041 041 041 041 041 041 041 041 041 041 041 041 041 041 041 041 041 041 041 041 041 041 041 041 041 041 041 041 041 041 041 041 041 041 041 041 041 041 041 041 041 041 041 041 041 041 041 041 041 041
041 041 041 041 041 041 041 041 041 041 041 041 041 041 041 041 041 041 041 041 041 041 041 041 041 041 041 041 041 041 041 041 041 041 041 041 041 041 041 041 041 041 041 041 041 041 041 041 041 041
041 041 041 041 041 041 041 041 041 041 041 041 041 041 041 041 041 041 041 041 041 041 041 041 041 041 041 041 041 041 041 041 041 041 041 041 041 041 041 041 041 041 041 041 041 041 041 041 041 041
041 041 041 041 041 041 041 041 041 041 041 041 041 041 041 041 041 041 041 041 041 041 041 041 041 041 041 041 041 041 041 041 041 041 041 041 041 041 041 041 041 041 041 041 041 041 041 041 041 041
041 041 041 041 041 041 041 041 041 041 041 041 041 041 041 041 041 041 041 041 041 041 041 041 041 041 041 041 041 041 041 041 041 041 041 041 041 041 041 041 041 041 041 041 041 041 041 041 041 041
041 041 041 041 041 041 041 041 041 041 041 041 041 041 041 041 041 041 041 041 041 041 041 041 041 041 041 041 041 041 041 041 041 041 041 041 041 041 041 041 041 041 041 041 041 041 041 041 041 041